11111111131111111111111111111111111111111111111111
11111111221122221122111111112211222211221111111111
11111111221122222222111111112211222211221111111111
11111111221122222222111111112211222211221111111111
11111111221122221122111111112211222211221111111111
11111111221111111122111111112211122111221111111111
11111111221111111122111111112211122111221111111111
11222222222222222222222222222222222222222222222211
11222222222222222222222222222222222222222222222211
11111111221111111122111111112211111111221111111111
11111111221111111122111111112211111111221111111111
11222211221111111122111111112211111111221122221111
11222211221111111122112221112211111111222222222211
11222211221111111122112222222211111111221122222211
11222211221111111122112222222211111111221122221111
11122111221111111122111221112211111111221111111111
11122111221111111122111221112211111111221111111111
11222222222222222222222222222222222222222222222211
11222222222222222222222222222222222222222222222211
11111111221122221122111111112211222211221111111111
11111111221122222222111111112211222211221111111111
11111111221122222222111111112211222211221111111111
11111111221122221122111111112211222211221111111111
11111111221111111122111111112211122111221111111111
11111111221111111122111111112211122111221111111111
11222222222222222222222222222222222222222222222211
11222222222222222222222222222222222222222222222211
11111111221111111122111111112211111111221111111111
11111111221111111122111111112211111111221111111111
11111111221111111122112222112211111111221111111111
11222111221111111122112222112211111111221122211111
11222222221111111122112222112211111111221122222211
11222222221111111122112222112211111111221122222211
11122111221111111122111221112211111111221112211111
11122111221111111122111221112211111111221112211111
11222222222222222222222222222222222222222222222211
11222222222222222222222222222222222222222222222211
11111111221111111122111111112211111111221111111111
11111111221111111122111111112211111111221111111111
11111111221111111122111111112211111111221111111111
11111111221111111122111111112211111111221111111111
11111111221111111122111111112211111111221111111111
11111111221111111122111111112211111111221111111111
11111111221111111122111111112211111111221111111111
11111111221111111122111111112211111111221111111111
11111111311111111111111111111111111111111111111111